20 20
.........T.......G.T
XX...XX....0000....T
X..................T
XXXXXXX............T
....X..............T
XX..X.X............T
....XXX............T
XX...XX.K..........T
S..................T
XX...XX............T