20 20
.........T.........T
XX...XX............T
X..................T
XXXXXXX............T
....XG.............T
XX..XGX............T
....XXX............T
XX...XX.K..........T
S..................T
XX...XX............T