20 20
.........T.........T
XX...XX....XXXX....T
X..........0X00....T
XXXXXXX....XXXX....T
....XG.....XX00....T
XX..XGX.....0000...T
....XXX......GG....T
XX...XX.K..........T
S...........XXXXX..T
XX...XX............T