20 20
.........T.........T
XX...XX....0000....T
X..........0000....T
XXXXXXX....0000....T
....XG.....0000....T
XX..XGX.....0000...T
....XXX............T
XX...XX.K..........T
S..................T
XX...XX............T