20 20
XXXXXXXXXXXXXXXXXXXX
X.....T...........X.
X.XX.....XXX.....X.X
X.XX..G..XXX.....X.X
X..........K......X.
X.XX....XXXXXX.XXX.X
X.....G.........X..X
X.XXXXX.XXXXXX.X.X.X
X....XX............X
XXXX....XX..XX..XX.X
....X..............X
.XXXX..XXXXXX.....X.
X.............X....X
X.XXX..XXXXXX......X
X..................X
XXXXXX.XXXXXXX.XXX.X
X...............X..X
X.XXXXXX.XXXXX.XXXX
X..................
XXXXXXXXXXXXXXXX..S
